{"1":


{"terrain":["w=======================================",
"=......................................=",
"=......................................=",
"=.......wwwwwwww.......................=",
"=.......w..M...w.......................=",
"=.......w..T...wwwwwwwwwwwww...........=",
"=.......w......wfffffffffffw...........=",
"=.wwwwwwwwwffwwwfffffffffffw...........=",
"=.wffffffffffffffffffffffffw...........=",
"=.wffffffffffffffffffffffffw...........=",
"=.wffffffffffffffffffffffffw...........=",
"=.wffffffffffffffffffffffffw...........=",
"=.wffffffffffffffffffffffffw...........=",
"=.wwwwwwwwwwwwwwwwwwffffwwww...........=",
"=..w...............w....w..............=",
"=..w...............w....w..............=",
"=..w....................w..............=",
"=..w....................w..............=",
"=..w...............w....w..............=",
"=..w...............ww..ww..............=",
"=wwwwwwwww..........w..w...............=",
"=w.......wwwwwwwwwwww..w...............=",
"=w.....................w...............=",
"=w...x.................w...............=",
"=w.......wwwwww wwwwwwww...............=",
"=wwwwwwwww....w.w......................=",
"=.............w.w......................=",
"=......................................=",
"=......................................=",
"=......................................=",
"=......................................=",
"=......................................=",
"=......................................=",
"=......................................=",
"========================================"
],"monster spawns":["w=======================================",
"=......................................=",
"=......................................=",
"=.......wwwwwwww.......................=",
"=.......w..M...w.......................=",
"=.......w..T...wwwwwwwwwwwww...........=",
"=.......w......w...........w...........=",
"=.wwwwwwwww..www...........w...........=",
"=.w........................w...........=",
"=.w.....h....h.....h.......w...........=",
"=.w........................w...........=",
"=.w........................w...........=",
"=.w..................e.....w...........=",
"=.wwwwwwwwwwwwwwwwww....wwww...........=",
"=..w...............w....w..............=",
"=..w...............w....w..............=",
"=..w....................w..............=",
"=..w....................w..............=",
"=..w...............w....w..............=",
"=..w...............ww..ww..............=",
"=wwwwwwwww..........w..w...............=",
"=w...h...wwwwwwwwwwww..w...............=",
"=w........M.M..........w...............=",
"=w...x.................w...............=",
"=w.......wwwwww wwwwwwww...............=",
"=wwwwwwwww....w.w......................=",
"=.............w.w......................=",
"=......................................=",
"=......................................=",
"=......................................=",
"=......................................=",
"=......................................=",
"=......................................=",
"=......................................=",
"========================================"
]


,"monster paths":["w=======================================",
"=......................................=",
"=......................................=",
"=.......wwwwwwww.......................=",
"=.......w.RRD..w.......................=",
"=.......w.UTD..wwwwwwwwwwwww...........=",
"=.......w.ULL..w...........w...........=",
"=.wwwwwwwww..www...........w...........=",
"=.w........................w...........=",
"=.w.DLLLLLLLLLLLLLLLLLL....w...........=",
"=.w.D............RRRRRU....w...........=",
"=.w.RRRRRRRRRRRRRU..DLLL...w...........=",
"=.w.................RRRU...w...........=",
"=.wwwwwwwwwwwwwwwwww....wwww...........=",
"=......................................=",
"=......................................=",
"=......................................=",
"=......................................=",
"=..................x...................=",
"=......................................=",
"=......................................=",
"=......................................=",
"=......................................=",
"=......................................=",
"=......................................=",
"=......................................=",
"=......................................=",
"=......................................=",
"=......................................=",
"=......................................=",
"=......................................=",
"=......................................=",
"=......................................=",
"=......................................=",
"========================================"]},


"2":{"terrain":["w=======================================",
"=......................................=",
"=......................................=",
"=.......wwwwwwww.......................=",
"=.......w..M...w.......................=",
"=.......w..T...wwwwwwwwwwwww...........=",
"=.......w......w...........w...........=",
"=.wwwwwwwww..www...........w...........=",
"=.w........................w...........=",
"=.w.....h....h.....h.......w...........=",
"=.w........................w...........=",
"=.w........................w...........=",
"=.w..................e.....w...........=",
"=.wwwwwwwwwwwwwwwwww....wwww...........=",
"=......................................=",
"=.....................x................=",
"=......................................=",
"=......................................=",
"=......................................=",
"=......................................=",
"=......................................=",
"=......................................=",
"=......................................=",
"=......................................=",
"=......................................=",
"=......................................=",
"=......................................=",
"=......................................=",
"=......................................=",
"=......................................=",
"=......................................=",
"=......................................=",
"=......................................=",
"=......................................=",
"========================================"
],"monster spawns":["w=======================================",
"=......................................=",
"=......................................=",
"=.......wwwwwwww.......................=",
"=.......w..M...w.......................=",
"=.......w..T...wwwwwwwwwwwww...........=",
"=.......w......w...........w...........=",
"=.wwwwwwwww..www...........w...........=",
"=.w........................w...........=",
"=.w.....h....h.....h.......w...........=",
"=.w........................w...........=",
"=.w........................w...........=",
"=.w..................e.....w...........=",
"=.wwwwwwwwwwwwwwwwwwhhhewwww...........=",
"=....................x.................=",
"=......................................=",
"=......................................=",
"=......................................=",
"=......................................=",
"=......................................=",
"=......................................=",
"=......................................=",
"=......................................=",
"=......................................=",
"=......................................=",
"=......................................=",
"=......................................=",
"=......................................=",
"=......................................=",
"=......................................=",
"=......................................=",
"=......................................=",
"=......................................=",
"=......................................=",
"========================================"
],"monster paths":["w=======================================",
"=......................................=",
"=......................................=",
"=.......wwwwwwww.......................=",
"=.......w.RRD..w.......................=",
"=.......w.UTD..wwwwwwwwwwwww...........=",
"=.......w.ULL..w...........w...........=",
"=.wwwwwwwww..www...........w...........=",
"=.w........................w...........=",
"=.w.DLLLLLLLLLLLLLLLLLL....w...........=",
"=.w.D............RRRRRU....w...........=",
"=.w.RRRRRRRRRRRRRU..DLLL...w...........=",
"=.w.................RRRU...w...........=",
"=.wwwwwwwwwwwwwwwwww....wwww...........=",
"=......................................=",
"=......................................=",
"=......................................=",
"=......................................=",
"=..................x...................=",
"=......................................=",
"=......................................=",
"=......................................=",
"=......................................=",
"=......................................=",
"=......................................=",
"=......................................=",
"=......................................=",
"=......................................=",
"=......................................=",
"=......................................=",
"=......................................=",
"=......................................=",
"=......................................=",
"=......................................=",
"========================================"]},



"3":["w=======================================",
"=.....w................................=",
"=.....w................................=",
"=.....w................................=",
"=.....w................................=",
"=......................................=",
"=......................................=",
"=......................................=",
"=......................................=",
"=......................................=",
"=......................................=",
"=......................................=",
"=......................................=",
"=......................................=",
"=......................................=",
"=...........M..............M...........=",
"=.................x....................=",
"=......................................=",
"=......................................=",
"=............w.........................=",
"=......................................=",
"=......................................=",
"=......................................=",
"=......................................=",
"=......................................=",
"=......................................=",
"=......................................=",
"=......................................=",
"=......................................=",
"=......................................=",
"=......................................=",
"=......................................=",
"=......................................=",
"=......................................=",
"=......................................=",
"=......................................=",
"=......................................=",
"=......................................=",
"=......................................=",
"========================================"]
}