{"1":["========================================",
"=..................w...................=",
"=..M...............w...................=",
"=..................w...................=",
"=..........w.......w...................=",
"=.............e.M.Mw...................=",
"=............wxeM..w...................=",
"=.Mwwwwwwwwwww.wwwwwwwwwwwwwwwwwwwwwwww=",
"=....w.w...........w...................=",
"=....w.w...........w...................=",
"=........T.........w...................=",
"=..................w...................=",
"=..................w...................=",
"=..................w...................=",
"=...w..............w...................=",
"=..................w...................=",
"=..................w...................=",
"=..................w...................=",
"=......................................=",
"=......................................=",
"=......................................=",
"=......................................=",
"=......................................=",
"=......................................=",
"=......................................=",
"=......................................=",
"=......................................=",
"=......................................=",
"=......................................=",
"=......................................=",
"=......................................=",
"=......................................=",
"=......................................=",
"=......................................=",
"=......................................=",
"=......................................=",
"=......................................=",
"=......................................=",
"========================================"
],


"2":["w=======================================",
"=....w.............................................=",
"=.....w................................=",
"=.....w................................=",
"=.....w................................=",
"=......................................=",
"=..............w.........w.............=",
"=..............w.........w.............=",
"=..............w.........w.............=",
"=..............w.....wwwww.............=",
"=..............w..wwww...M....x........=",
"=..............w..w....................=",
"=..............w..w....................=",
"=......................................=",
"=......................................=",
"=................w.....................=",
"=......................................=",
"=......................................=",
"=......................................=",
"=......................................=",
"=......................................=",
"=......................................=",
"=......................................=",
"=......................................=",
"=......................................=",
"=......................................=",
"=......................................=",
"=......................................=",
"=......................................=",
"=......................................=",
"=......................................=",
"=......................................=",
"=......................................=",
"=......................................=",
"=......................................=",
"=......................................=",
"=......................................=",
"=......................................=",
"========================================"
]
,"3":["w=======================================",
"=.....w...............................=",
"=.....w................................=",
"=.....w................................=",
"=.....w................................=",
"=..............wwwwwwwwwww.............=",
"=..............w.........w.............=",
"=..............w.........w.............=",
"=..............w.........w.............=",
"=..............w.....wwwww.............=",
"=..............w..wwww.................=",
"=..............w..w....................=",
"=..............w..w....................=",
"=...........M...M......................=",
"=...........M..............M...........=",
"=.................x.....T..............=",
"=......................................=",
"=......................................=",
"=............w.........................=",
"=......................................=",
"=......................................=",
"=......................................=",
"=......................................=",
"=......................................=",
"=......................................=",
"=......................................=",
"=......................................=",
"=......................................=",
"=......................................=",
"=......................................=",
"=......................................=",
"=......................................=",
"=......................................=",
"=......................................=",
"=......................................=",
"=......................................=",
"=......................................=",
"=......................................=",
"========================================"]
}