{"1":["w=======================================",
"=.....w................................=",
"=.....w................................=",
"=.....w................................=",
"=.....w................................=",
"=..............wwwwwwwwwww.............=",
"=..............w.........w.............=",
"=..............w.........w.............=",
"=..............w.........w.............=",
"=..............w.....wwwww.............=",
"=..............w..wwww.................=",
"=..............w..w....................=",
"=..............w..w.......M............=",
"=...................wx.................=",
"=......................................=",
"=................w......T..............=",
"=......................................=",
"=......................................=",
"=......................................=",
"=......................................=",
"=......................................=",
"=......................................=",
"=......................................=",
"=......................................=",
"=......................................=",
"=......................................=",
"=......................................=",
"=......................................=",
"=......................................=",
"=......................................=",
"=......................................=",
"=......................................=",
"=......................................=",
"=......................................=",
"=......................................=",
"=......................................=",
"=......................................=",
"=......................................=",
"========================================"
],


"2":["w=======================================",
"=....w................................=",
"=.....w................................=",
"=.....w................................=",
"=.....w................................=",
"=......................................=",
"=..............w.........w.............=",
"=..............w.........w.............=",
"=..............w.........w.............=",
"=..............w.....wwwww.............=",
"=..............w..wwww...M....x........=",
"=..............w..w....................=",
"=..............w..w....................=",
"=......................................=",
"=......................................=",
"=................w.....................=",
"=......................................=",
"=......................................=",
"=......................................=",
"=......................................=",
"=......................................=",
"=......................................=",
"=......................................=",
"=......................................=",
"=......................................=",
"=......................................=",
"=......................................=",
"=......................................=",
"=......................................=",
"=......................................=",
"=......................................=",
"=......................................=",
"=......................................=",
"=......................................=",
"=......................................=",
"=......................................=",
"=......................................=",
"=......................................=",
"========================================"
]}